बाल बहुत लंबे हैं	The hair is very long
कल नहीं आएगा	He will not come tomorrow
उसका हाथ साफ़ है	He's innocent
वह ऊपर गिर गया	He fell from above
दिल बैठ गया	He lost courage
दाल में कुछ काला है	Something’s fishy
उसने आकाश छू लिया	He achieved great success
कल मैं बहुत पीछे था	Yesterday I was far behind
उसकी आँखें खुल गईं	He realized the truth
हमारे हाथ पाँव फूल गए	Unable to move freely
आँखों का तारा है	Very beloved person
वह बूंद-बूंंद गिन रहा है	He is calculating every little bit
वह हाथ पर हाथ धरकर बैठा है	He is sitting idle
वह चला गया	He left
वह ऊपर गया	He died
वह भगवान के पास चला गया	He died
मुझे ठंड लग रही है	The cold is stuck to stuck to me 
वह भारी है	He is important
उसका दिल बड़ा है	He is generous
वह साफ है	He is clear
वह हल्का है	He is mild or not serious
वह सीधा है	He is simple or honest.
वह भारी आवाज़ में बोला	He spoke in a deep or serious tone.
वह बड़ा है	He is older
उसका चेहरा उतर गया	He was disappointed
वह चला रहा है	He is driving 
वह काम नहीं करता	He is unemployed
उसका मूड खराब है	He is upset
वह जल गया	He is jealous
वह खुला है	It is available
वह मेरे हाथों में टूट गया	He broke down in my hands
उसका चेहरा चमक रहा है	He is happy
वह हिल गया	He was emotionally taken
यह बात बड़ी है	This matter is serious
उसकी तबीयत खराब है	He is sick
वह चल रहा है	It is ongoing / in progress
वह खाली है	He is free
उसका दिमाग ख़ाली है	He is stupid
वह भारी काम है	It is difficult work
वह गिरा हुआ आदमी है  He is corrupt
वह तेज दिमाग वाला है  He is clever
वह हल्की आवाज़ में बोला He spoke softly
वह ऊँचा बोलता है	He speakes loudly
वह अपने ही पैरों पर खड़ा है	He is indepenent
दिल जलना	Jealousy or Envy
उसका दिमाग खराब है	He is crazy
उसकी बोलती बंद हो गई	He is speachless
वह बड़ी मछली है	He is powerful
वह बहुत हवा में उड़ रहा है	He is flying in the air a lot 
उसके पेट में चूहे कूद रहे हैं	He is really hungry